201 205 205 205 205 205 205 205 205 205 205 205 205 205 205 205 205 205 205 205 205 205 205 205 205 205 205 205 205 205 205 205 205 205 205 4 205 205 205 187  
186 0 0 254 254 254 254 254 254 254 254 254 254 254 0 0 0 0 0 254 254 254 254 254 254 254 254 254 254 254 254 254 0 254 254 0 254 254 254 186 
186 254 0 0 0 254 254 254 254 254 254 254 254 254 0 254 254 254 0 254 254 254 0 0 0 0 0 0 0 0 254 254 0 254 254 0 0 0 254 186 
186 254 0 254 0 176 254 254 254 254 254 254 254 254 254 254 254 254 0 0 0 254 0 254 254 254 254 254 254 0 254 254 0 254 254 254 254 0 254 186 
186 254 254 254 0 176 176 0 0 0 0 0 0 254 254 254 254 254 0 254 0 0 0 254 254 0 0 0 254 0 0 0 0 0 0 254 0 0 0 186 
186 254 254 254 0 0 0 0 254 254 254 254 0 254 0 0 0 254 0 254 254 254 254 254 254 254 254 0 254 0 254 254 254 254 0 254 0 254 0 186 
186 254 254 254 254 254 254 254 254 254 254 254 0 254 0 254 0 254 0 0 254 254 254 254 254 254 254 0 254 0 254 254 254 254 0 254 0 254 0 186 
186 254 254 0 0 0 254 254 254 0 0 0 0 0 0 0 0 0 254 0 254 254 254 0 0 254 254 0 0 0 254 254 0 254 0 254 0 254 0 186 
186 254 254 254 254 254 254 254 254 254 254 254 254 254 254 254 254 0 0 0 254 254 254 254 254 254 254 254 254 254 254 254 254 254 0 0 0 254 0 186
200 205 205 205 205 205 205 205 205 205 205 205 205 205 205 205 205 205 205 205 205 205 205 205 205 205 205 205 205 205 205 205 205 205 205 205 205 205 205 188 