201 205 205 205 205 205 205 205 205 205 205 205 205 205 205 205 205 205 205 205 205 205 205 205 205 205 205 205 205 205 205 205 205 205 205 205 205 205 205 187 
186 0 0 0 254 254 254 254 0 254 254 0 0 0 0 254 0 254 254 254 0 254 254 254 0 254 254 254 254 0 254 254 254 254 254 254 254 254 0 186 
186 0 0 0 0 0 0 0 0 0 0 0 0 254 0 0 0 254 254 254 254 254 254 0 0 254 0 0 254 0 254 254 254 254 254 254 0 254 0 186 
186 0 254 254 254 254 254 254 0 254 0 254 254 254 254 254 0 254 254 0 0 254 254 0 0 0 0 0 254 0 254 254 254 254 254 254 0 0 0 4 
186 0 254 0 254 0 0 0 0 254 0 0 0 0 254 254 0 254 254 0 0 254 0 0 254 0 254 0 0 0 0 254 0 0 254 254 0 0 254 186 
186 0 0 0 254 254 254 0 254 254 254 0 0 0 254 254 0 0 0 0 0 0 0 254 0 0 254 254 0 254 0 254 0 0 0 0 254 0 0 186 
186 0 254 0 254 254 254 0 254 0 254 254 254 0 254 254 254 254 254 0 254 254 0 254 254 0 254 254 0 254 0 0 0 254 254 0 0 0 0 186 
186 0 254 0 254 254 254 0 0 254 254 254 254 254 0 254 254 254 254 254 254 0 0 0 254 0 254 254 254 254 254 0 254 254 254 0 0 0 0 186 
186 0 254 254 254 254 254 254 254 0 254 254 254 254 254 0 254 254 254 254 0 0 254 254 254 254 254 254 254 254 254 254 254 254 254 254 0 254 254 186
200 205 205 205 205 205 205 205 205 205 205 205 205 205 205 205 205 205 205 205 205 205 205 205 205 205 205 205 205 205 205 205 205 205 205 205 205 205 205 188